2121312322
1        2
2   12   4
4    3   1
16       3
2        1
12   5   1
212    1 1
2      2 f
1212353211