1221311211
1        1
1    23  4
5     2  4
5  3     5
5  22    4
1        4
2        2
23      32
1112332111